; SOKOBAN Ver. 1.0
; Archivo con la descripcion de varios niveles de juego
#1
0,0,0,0,1,1,1,1,1
0,0,0,0,1,2,2,2,1 
0,0,0,0,1,4,2,2,1
0,0,1,1,1,2,2,4,1,1 
0,0,1,2,2,4,2,4,2,1
1,1,1,2,1,2,1,1,2,1,0,0,0,1,1,1,1,1,1 
1,2,2,2,1,2,1,1,2,1,1,1,1,1,2,2,3,3,1
1,2,4,2,2,4,2,2,2,2,2,2,2,2,2,2,3,3,1 
1,1,1,1,1,2,1,1,1,2,1,6,1,1,2,2,3,3,1
0,0,0,0,1,2,2,2,2,2,1,1,1,1,1,1,1,1,1 
0,0,0,0,1,1,1,1,1,1,1

#2
1,1,1,1,1,1,1,1,1,1,1,1
1,3,3,2,2,1,2,2,2,2,2,1,1,1
1,3,3,2,2,1,2,4,2,2,4,2,2,1
1,3,3,2,2,1,4,1,1,1,1,2,2,1
1,3,3,2,2,2,2,6,2,1,1,2,2,1
1,3,3,2,2,1,2,1,2,2,4,2,1,1
1,1,1,1,1,1,2,1,1,4,2,4,2,1
0,0,1,2,4,2,2,4,2,4,2,4,2,1
0,0,1,2,2,2,2,1,2,2,2,2,2,1
0,0,1,1,1,1,1,1,1,1,1,1,1,1

#3
0,0,0,0,0,0,0,0,1,1,1,1,1,1,1,1
0,0,0,0,0,0,0,0,1,2,2,2,2,2,6,1
0,0,0,0,0,0,0,0,1,2,4,1,4,2,1,1
0,0,0,0,0,0,0,0,1,2,4,2,2,4,1
0,0,0,0,0,0,0,0,1,1,4,2,4,2,1
1,1,1,1,1,1,1,1,1,2,4,2,1,2,1,1,1
1,3,3,3,3,2,2,1,1,2,4,2,2,4,2,2,1
1,1,3,3,3,2,2,2,2,4,2,2,4,2,2,2,1
1,3,3,3,3,2,2,1,1,1,1,1,1,1,1,1,1
1,1,1,1,1,1,1,1

#4
0,0,0,0,0,0,0,0,0,0,0,1,1,1,1,1,1,1,1
0,0,0,0,0,0,0,0,0,0,0,1,2,2,3,3,3,3,1
1,1,1,1,1,1,1,1,1,1,1,1,2,2,3,3,3,3,1
1,2,2,2,2,1,2,2,4,2,4,2,2,2,3,3,3,3,1
1,2,4,4,4,1,4,2,2,4,2,1,2,2,3,3,3,3,1
1,2,2,4,2,2,2,2,2,4,2,1,2,2,3,3,3,3,1
1,2,4,4,2,1,4,2,4,2,4,1,1,1,1,1,1,1,1
1,2,2,4,2,1,2,2,2,2,2,1
1,1,2,1,1,1,1,1,1,1,1,1
1,2,2,2,2,1,2,2,2,2,1
1,2,2,2,2,2,4,2,2,2,1,1
1,2,2,4,4,1,4,4,2,2,6,1
1,2,2,2,2,1,2,2,2,2,1,1
1,1,1,1,1,1,1,1,1,1,1

#5
0,0,0,0,0,0,0,0,1,1,1,1,1
0,0,0,0,0,0,0,0,1,2,2,2,1,1,1,1,1
0,0,0,0,0,0,0,0,1,2,1,4,1,1,2,2,1
0,0,0,0,0,0,0,0,1,2,2,2,2,2,4,2,1
1,1,1,1,1,1,1,1,1,2,1,1,1,2,2,2,1
1,3,3,3,3,2,2,1,1,2,4,2,2,4,1,1,1
1,3,3,3,3,2,2,2,2,4,2,4,4,2,1,1
1,3,3,3,3,2,2,1,1,4,2,2,4,2,6,1
1,1,1,1,1,1,1,1,1,2,2,4,2,2,1,1
0,0,0,0,0,0,0,0,1,2,4,2,4,2,2,1
0,0,0,0,0,0,0,0,1,1,1,2,1,1,2,1
0,0,0,0,0,0,0,0,0,0,1,2,2,2,2,1
0,0,0,0,0,0,0,0,0,0,1,1,1,1,1,1

#6
1,1,1,1,1,1,0,0,1,1,1
1,3,3,2,2,1,0,1,1,6,1,1
1,3,3,2,2,1,1,1,2,2,2,1
1,3,3,2,2,2,2,2,4,4,2,1
1,3,3,2,2,1,2,1,2,4,2,1
1,3,3,1,1,1,2,1,2,4,2,1
1,1,1,1,2,4,2,1,4,2,2,1
0,0,0,1,2,2,4,1,2,4,2,1
0,0,0,1,2,4,2,2,4,2,2,1
0,0,0,1,2,2,1,1,2,2,2,1
0,0,0,1,1,1,1,1,1,1,1,1

#7
0,0,0,0,0,0,0,1,1,1,1,1
0,1,1,1,1,1,1,1,2,2,2,1,1
1,1,2,1,2,6,1,1,2,4,4,2,1
1,2,2,2,2,4,2,2,2,2,2,2,1
1,2,2,4,2,2,1,1,1,2,2,2,1
1,1,1,2,1,1,1,1,1,4,1,1,1
1,2,4,2,2,1,1,1,2,3,3,1
1,2,4,2,4,2,4,2,3,3,3,1
1,2,2,2,2,1,1,1,3,3,3,1
1,2,4,4,2,1,0,1,3,3,3,1
1,2,2,1,1,1,0,1,1,1,1,1
1,1,1,1

#8
0,0,1,1,1,1
0,0,1,2,2,1,1,1,1,1,1,1,1,1,1,1
0,0,1,2,2,2,2,4,2,2,2,4,2,4,2,1
0,0,1,2,4,1,2,4,2,1,2,2,4,2,2,1
0,0,1,2,2,4,2,4,2,2,1,2,2,2,2,1
1,1,1,2,4,1,2,1,2,2,1,1,1,1,2,1
1,6,1,4,2,4,2,4,2,2,1,1,2,2,2,1
1,2,2,2,2,4,2,1,4,1,2,2,2,1,2,1
1,2,2,2,4,2,2,2,2,4,2,4,2,4,2,1
1,1,1,1,1,2,2,1,1,1,1,1,1,1,1,1
0,0,1,2,2,2,2,2,2,1
0,0,1,2,2,2,2,2,2,1
0,0,1,3,3,3,3,3,3,1
0,0,1,3,3,3,3,3,3,1
0,0,1,3,3,3,3,3,3,1
0,0,1,1,1,1,1,1,1,1

#9
0,0,0,0,0,0,0,0,0,0,1,1,1,1,1,1,1
0,0,0,0,0,0,0,0,0,0,1,2,2,3,3,3,1
0,0,0,0,0,0,1,1,1,1,1,2,2,3,3,3,1
0,0,0,0,0,0,1,2,2,2,2,2,2,3,2,3,1
0,0,0,0,0,0,1,2,2,1,1,2,2,3,3,3,1
0,0,0,0,0,0,1,1,2,1,1,2,2,3,3,3,1
0,0,0,0,0,1,1,1,2,1,1,1,1,1,1,1,1
0,0,0,0,0,1,2,4,4,4,2,1,1
0,1,1,1,1,1,2,2,4,2,4,2,1,1,1,1,1
1,1,2,2,2,1,4,2,4,2,2,2,1,2,2,2,1
1,6,2,4,2,2,4,2,2,2,2,4,2,2,4,2,1
1,1,1,1,1,1,2,4,4,2,4,2,1,1,1,1,1
0,0,0,0,0,1,2,2,2,2,2,2,1
0,0,0,0,0,1,1,1,1,1,1,1,1

#10
0,1,1,1,0,0,1,1,1,1,1,1,1,1,1,1,1,1,1
1,1,6,1,1,1,1,2,2,2,2,2,2,2,1,2,2,2,1
1,2,4,4,2,2,2,4,4,2,2,4,2,4,2,3,3,3,1
1,2,2,4,4,4,1,2,2,2,2,4,2,2,1,3,3,3,1
1,2,4,2,2,2,1,2,4,4,2,4,4,2,1,3,3,3,1
1,1,1,2,2,2,1,2,2,4,2,2,2,2,1,3,3,3,1
1,2,2,2,2,2,1,2,4,2,4,2,4,2,1,3,3,3,1
1,2,2,2,2,1,1,1,1,1,1,2,1,1,1,3,3,3,1
1,1,2,1,2,2,1,2,2,4,2,4,2,2,1,3,3,3,1
1,2,2,1,1,2,1,2,4,4,2,4,2,4,1,1,3,3,1
1,2,3,3,1,2,1,2,2,4,2,2,2,2,2,2,1,3,1
1,2,3,3,1,2,1,2,4,4,4,2,4,4,4,2,1,3,1
1,1,1,1,1,2,1,2,2,2,2,2,2,2,1,2,1,3,1
0,0,0,0,1,2,1,1,1,1,1,1,1,1,1,2,1,3,1
0,0,0,0,1,2,2,2,2,2,2,2,2,2,2,2,1,3,1
0,0,0,0,1,1,1,1,1,1,1,1,1,1,1,1,1,1,1
#